##########
#  O     #
# #OXPX  #
#   X    #
#   O    #
##########
