############
#        O #
#   P   ####
#          #
#######    #
#    ##    #
#    ##    #
#     O    #
#       XX #
#       #  #
############